.#######################...######.
#...#.....#.....#.......#..#......
#.###....###....#.......#..######.
#.#........#....#..####.#.......#.
#.###..#####......#.....#..######.
#.................####..#.........
#..#######.......#..@...#..######.
#..............###......#..#....#.
.############.##########...#....#.
#...#.....#.....#.......#..######.
#.###....###....#.......#.........
#.#........#....#..####.#...####..
#.###..#####......#.....#..#....#.
#.................####..#..######.
#..#######.......#......#..#....#.
#..............###......#.........
.############.##########...#####..
#...#.....#.....#.......#..#....#.
#.###....###....#.......#..#####..
#.#........#....#..####.#..#......
#.###..#####......#.....#.........
#.................####..#.........
#..#######.......#......#.........
#..............###......#.........
.#######################..........